.....@#...#
.###.......
...#.####..
#..........
###.......#
#####....#.
...........
.....#.###.
.....#.....
.....#.....
#....#.....