#.....#...#
.###.......
#..#.####..
#..........
#.#..@....#
#####....#.
...#.......
.....#.###.
#.#..#.....
.....#.....
#....#.....