...###
..##.#.####
.##..###..#
##........#
#......#..#
###..###..#
..#..#....#
.##.##.#.##
.#......##
.#.....##
.#######..@